1111111111111111111111111111111111
100000000000000C00000C000000000001
1010010100100000101001000C00010101
1010010010101010001001000P00010101
100000000C00C000000001000E000001C1
1111111111111111111111111111111111
