1111111111111
10010000C0001
1000011111011
100011E0P0001
1111111111111
