1111111111111111111111111111111111111111111111111111111111
10CCCCCCCCCCCCCCCCCCCCCCCCCCCCCCCCCCCCCCCCCCCCCCCCCCCCCCC1
1C111C111111111C111111111111111C11111111C111C11111C11111C1
1C111C111111111C111111111111111C11111111C111C11111C11111C1
1CCCCC111111111CC00CCCCCCCCCCCCCCCCCCCCCC111CCCCCCCCCCCCC1
11111C111CCCCCCC1101111C11111110000000000111C1111111C11111
11111C111C11111C1101111C11111110111001110111C1111111C11111
11111C111C11111C11K0011C11000110100K00010111C1100011C11111
1PCCCC111CC0111C1100011C11000110100CC0010111C1111111CCCCE1
11111C111111111C1100011C11000110111111110111C111CCCCC11111
11111C111111111C1111111C11111110000000000111C1111111C11111
11111C111111111C1111111C11111110111111110111C1111111C11111
1CCCCCCCCCCCCCCCCCCCCCCCCCCCCCCC11111111CCCCCCCCCCCCCCCCC1
1C1111C1111111111C11C1111111111CCCC11CCCC111111111C11111C1
1C1111C1111111111C11C1111111111C11C11C11C111111111C11111C1
1CCCCCCCCCCCCCCCCC11CCCCCCCCCCCC11CCCC11CCCCCCCCCCCCCCCCC1
1111111111111111111111111111111111111111111111111111111111
